572, 568
700, 390, 422
804, 566, 305, 357
404, 350, 144, 483, 359
720, 150, 403, 383, 487, 412
359,  39, 159, 143, 328, 368, 393
116, 114, 242, 589, 584, 548, 266, 397
100, 511, 372, 435, 255, 478, 258, 539, 363
300, 50, 370, 323, 233, 108, 381, 332, 321, 234
530, 500, 321, 123, 234, 432, 134, 431, 225, 502, 123
130, 200, 313, 421, 123, 321, 233, 322, 141, 342, 524, 321
312, 543, 315, 423, 94, 542, 432, 123, 543, 233, 555, 234, 342